██████████████████████
█                    █
█                    █
█                    █
█                    █
█         E S        █
█                    █
█                    █
█                    █
█         P          █
█                    █
██████████████████████
