______________________
|                    |
|                    |
|                    |
|                    |
|         E S        |
|                    |
|                    |
|                    |
|         P          |
|                    |
0123456789112345678921
