0_____________________
1                    |
2                    |
3                    |
4                    |
5         E S        |
6                    |
7                    |
8                    |
9         P          |
1                    |
0123456789112345678921
