++++++++++++++++++++++
+                    +
+                    +
+                    +
+                    +
+         E S        +
+                    +
+                    +
+                    +
+         P          +
+                    +
++++++++++++++++++++++
