++++++++++++++++++++++
+####################+
+####################+
+####################+
+####################+
+#########E#S########+
+####################+
+####################+
+####################+
+#########P##########+
+####################+
++++++++++++++++++++++
